NO ./images/NO.xpm
SO ./images/SO.xpm


WE ./images/WE.xpm


EA ./images/EA.xpm

F 255,153,15


C 255,255,255


        1111111111111111111111111
        1000000000000000000000001
        1100000000000000000000001   1111
        1000000000000000000000001   1001
111111111000000000000000000000001   1111
100000000000000000000000000001111
1000000000000AE00000000000001
10000000000000000000000000001
10001000010000000000000000001
1001 100000000000000000000001
10001000000000000001010000001
11000001110101011111011110101
11110111 1101111 101111010001
11111111 1111111 111111111111
