NO ./texture/wall_n.xpm
SO ./texture/wall_s.xpm
WE ./texture/wall_w.xpm
EA ./texture/wall_e.xpm

F 255,255,255
C 0,0,0

        1111111111111111111111111
        1000000000110000000000101
        1011000001110000000000111
        1001000000000000010000101
111111111011000001110000000000001
100000000011000001110111111111111
11110111111111011100000010001   1111
11110111111111011101010010001   1001
11000000110101011100000010001   10N1
10000000000000001100000010001   1111
10000000000000001101010010001
1100000111010101111101111000111
11110111 1110101 101111010001
11111111 1111111 111111111111
